10
WWWWWWWWWW
WWWWWWWWWW
WWWWWWWWWW
W---WWWWWW
W-p-b---gW
W---WWWWWW
WWWWWWWWWW
WWWWWWWWWW
WWWWWWWWWW
WWWWWWWWWW