10
WWWWWWWWWW
WWWW-gWWWW
WWWWb-WWWW
WWWW---WWW
WWWp--WWWW
WWWW---WWW
WWW---WWWW
WWWW-bWWWW
WWWWg-WWWW
WWWWWWWWWW
