10
WWWWWWWWWW
WWWWgWWWWW
WWWWgWWgWW
WWgbbbbgWW
WWWbbbbggW
WggbpbbWWW
WWgbbbbWWW
WWWgWggWWW
WWWgWWgWWW
WWWWWWWWWW
