10
WWWWWWWWWW
WWWWWgWWWW
WWWWW-WWWW
WWWWWbWWWW
WWg---b-pW
WWWWWbWWWW
WWWWW-WWWW
WWWWWgWWWW
WWWWWWWWWW
WWWWWWWWWW
