10
WWWWWWWWWW
WpbgWWWWWW
WWbbgWWWWW
WWgbbgWWWW
WWWgbbgWWW
WWWWgbbgWW
WWWWWgbbgW
WWWWWWgbWW
WWWWWWWgWW
WWWWWWWWWW
