10
WWWWWWWWWW
WWWWWWWWWW
WWWWWWWWWW
WWW----WWW
WWW-bg-WWW
WWW-gb-WWW
WWWp---WWW
WWWWWWWWWW
WWWWWWWWWW
WWWWWWWWWW
