10
WWWWWWWWWW
WWWWWWWWWW
WWg---gWWW
WW-WbW-WWW
WW-bpb-WWW
WW-Wb--WWW
WWg---gWWW
WWWWWWWWWW
WWWWWWWWWW
WWWWWWWWWW
