10
WWWWWWWWWW
WWWWWWWWWW
WWWWWWWWWW
WWWWW--WWW
Wp-bb---gW
WWWWWWgWWW
WWWWWWWWWW
WWWWWWWWWW
WWWWWWWWWW
WWWWWWWWWW
