10
WWWWWWWWWW
WWWWWWWWWW
WWWWW--WWW
WWWp---WWW
WWW-gWb-WW
WWWW----WW
WWWW--WWWW
WWWWWWWWWW
WWWWWWWWWW
WWWWWWWWWW
