10
WWWWWWWWWW
WWWWWWWWWW
WWWgWgWWWW
WWW---WWWW
WWWbbbWWWW
WWW-p-WWWW
WWWWgWWWWW
WWWWWWWWWW
WWWWWWWWWW
WWWWWWWWWW
