10
WWWWWWWWWW
WWWWWWWWWW
WWWg----gW
WWW--W-W-W
WWgbbbb--W
WWW-W-W--W
WWWp----gW
WWWWWWWWWW
WWWWWWWWWW
WWWWWWWWWW
